###########
# .   .   #
# $#$#$   #
## # # # ##
 #  +   $ #
 #   . .  #
 ##########

