  #######
  #  .  #
### $$  #
#  + # .#
#  $$  .#
#   .####
#########
