   ##############
   #   . . .    #
### $$$$$###$$  #
# +     #   .   #
#  ###  #   .   #
#      .#       #
#################
