##############
# . .   . .  #
# $$$$$ #    #
# # #  #  ## #
#   +   .    #
##############
