   ###################
   # . . .     .     #
### $$$$$$$$$###$$   #
#     #  ## +     .  #
# . # #  #   #   .   #
#   .   #    .   #   #
######################
