###############
# . . .     . #
# $$$$$$ ###  #
# #   #   #  $#
#   +   . #   #
#   ###   .   #
###############
