    ##########
    #   .    #
 #####$### # #
## . # $ $ # #
# +    $ #  .#
#   .  # .   #
##############
